+++++++++++++++++++++++++++++++++++++++++
+s      + + + +   + +                 + +
+ +++ +++ + + +++ + + +++++++++++ + + + +
+   +       +     + +     + + + + + +   +
+++++++ +++ +++ +++ + +++ + + + + + +++++
+ +   + +   + +       +       + + +     +
+ + + +++ + + +++++ +++++++ +++ +++ +++++
+   + +   + +     +   + +       +   +   +
+++++ + +++ +++ + + + + + +++ +++ + + +++
+       +   +   +   + +     +   + +     +
+++ + +++ + + + + +++ + +++++++ +++ + + +
+   +   + + + + +   + +       +   + + + +
+++++++++ +++++ + + + +++++++ + +++ +++++
+         + + + + + + +   +   +  e+ + + +
+ +++++ + + + +++ +++ +++ +++++ +++++ + +
+   + + +     + +   + +       +       + +
+ +++ +++++++++ + +++++ +++++ +++++ + + +
+ + + +           +     + +   +   + +   +
+ + + +++ + +++++ +++++ + +++++++ + + +++
+         + +     +                 +   +
+++++++++++++++++++++++++++++++++++++++++ 