+++++++++++++++++++++++++++++++++++++++++
+s  +   +   + +   + +       +     +   + +
+ +++++ + +++ + +++ +++ +++++++++ +++ + +
+   +           +             +         +
+++ + + + +++ + +++++ + + +++++ + + + +++
+   + + + +   +       + +       + + + + +
+ + + + + + + +++ +++++++++ + +++ +++++ +
+ + + + + + + + + +       + + +         +
+ +++++ +++++ + + +++++ + + +++ +++ +++++
+   +     + +   + + +   +     +   +   + +
+ +++++ + + + +++++ +++ + +++ + +++ +++ +
+       + +   + + +     + +   +   +     +
+++ +++ +++++++ + + +++ +++++++++++ +++++
+   +   + + +   + + + + + +     +   +   +
+ + +++ + + + + + + + + + +++++ +++ + +++
+ +   +       + + +   + +   +       + + +
+++ +++++ +++++++ + + +++++ +++ + + + + +
+       + + + +     +     + +   + +   + +
+++ + + +++ + +++ +++++ +++ +++ +++++++ +
+ + + +   +   + +   +   +     +   +   + +
+ +++ +++++ +++ +++ + + +++ +++++++++ + +
+         +   + +   + +            e  + +
+++ + +++ +++ + +++++++++ +++ +++ + +++ +
+   + +     +               + +   +     +
+++++++++++++++++++++++++++++++++++++++++ 