+++++++++++++++++++++++++++++++++++++++++++++++++++
+          + +     + + + +             +          +
+ + +++ + + + +++ + + + +++++++ +++ +++ +++ +++++++
+ + +   +     + +               +         +       +
+ + +++++ + + + + +++ +++ +++++++++ + + + +++ +++++
+ +   +   + +   + +     + +   + + + + + + +   +   +
+ +++++++++++++ +++ +++++++++ + + +++ +++ + +++ +++
+ +             +       + +         e   + + +     +
+ + +++ + +++ +++ +++++ + +++ + + +++++ +++++ +++++
+ +   + +   + + +   +   + +   + + +   +   +   + + +
+ +++++++++++++ +++ +++++ +++++ +++++ +++ + + + + +
+ +   +           +       + +     +     +   + +   +
+ +++ +++ + +++++++ +++++ + +++ + + + +++++ + +++ +
+     +   +s  +       + + +   + +   + +     + +   +
+ +++ +++++++ +++ +++ + + +++ +++++++++++ + + + + +
+   + +       +   +   +         +   +   + + +   + +
+ +++ +++ +++ +++ +++++++ + +++ +++ + + +++++++ +++
+ +   + + +   +         + + + + + +   + + + + +   +
+ +++ + + +++++ +++ + + +++ + +++ +++ +++ + + + + +
+ +     +     + + + + +   +           +   +     + +
+ +++ + + +++++++ +++++ + + +++ + +++++ + + + +++++
+   + +   +     +       + + + + +     + +   +     +
+++ +++ + +++++ +++++ +++++ + + + +++++ +++++ + + +
+     + +               +   +   +     + +     + + +
+++++++++++++++++++++++++++++++++++++++++++++++++++ 
