+++++++++++++++++++++
+ +       +   + +   +
+ + +++ +++ + + + +++
+ + +   + + +       +
+ +++ + + +++++ + +++
+   + + +       + e +
+ +++++ + +++++ +++++
+       +   +       +
+ +++++ +++ +++++ + +
+ +   +   + +   + + +
+++++ + +++ + + +++++
+     +   + + + + + +
+ + +++ +++ + + + + +
+ + +   +     + +   +
+ + + + +++ +++++++ +
+ + + + +   +   +   +
+++ + +++++ + + +++ +
+   s +       + +   +
+ + + +++ +++ +++++ +
+ + +       +       +
+++++++++++++++++++++ 
